1111111111
100C000001
100C000111
100C000101
100C000101
100000E111
10001000P1
1111110111
1000000001
100C000001
100C000111
100C000101
1000000111
1000100001
1111111111