1111111111
100C000001
100C000111
100C000101
100C0001E1
1000000111
1000100001
1111110111
1000000001
100C000001
100C000111
100C000101
100P000111
1000100001
1111111111