111111111111111111
100C0000000C000001
100C000111100C0001
100C0000100C000001
100C00E10100001001
100000100C00001101
1000100001100C0001
111111000100C00001
100001000010000101
100C00000100C00001
100C00011100C00001
100C00001100C00001
100P00000000010101
100010000101001101
111111111111111111